111111111111111111111111111111
100000000000000C00000C0000E001
101001C10010000010100100000001
101001101P10101K00100100000K01
100000000C00C00000000000000001
111111C1101111111K111111111101
110000C0011111C110101111101111
100K0000C000000C00000C0001K001
101000C000100K001010010K111001
101001C0101010100K100100C00001
100000000C00C00000CCC000000101
111111111111111111111111111111