1111111111111111111111111111111111
100000000000000C00000C000000000001
101001C100100000101001000000010101
101001101P101010001001000000010101
100000000C00C0000000000000000000C1
111111C110111111101111111111011011
110000C0E11111C11110111110111C1011
10000000C000000C00000C000100000001
101000C00010000010100100111001C101
101001C01010101000100100C00001C101
100000000C00C00000CCC000000100C1C1
1111111111111111111111111111111111