






111111111111111111111111111111
100000000000000C00000C00000001
101001C10010000010100100000001
101001101P10101000100100000001
100000000C00C00000000000000001
111111C11011111110111111111101
110000C0E11111C110101111101111
10000000C000000C00000C00010001
101000C00010000010100100111001
101001C01010101000100100C00001
100000000C00C00000CCC000000101
111111111111111111111111111111









