1111111111111111
10P00C0000C00001
1CE100000C00C001
1111111111111111
