1111111111111111
10P00C0000C00101
1EC10C0110C0C001
11111C11C0CC1101
11111C11C0CC1101
11111C11C0CC1101
11111C11C0CC1101
11111C11C0CC1101
11111C11C0CC1101
11111C11C0CC1101
11000011C1C101C1
1111111111111111