1111111111111111
10P00C1000C00101
1C0100001C01C001
10C00C01C0C10101
10C00C11C0C00101
1C110C11101C1101
10C1CC11C0110101
1EC10C0110C0C101
11111C11C0CC1101
11000011C1C101C1
1111111111111111