1111111111111111
10P00C1000C00101
1CE100001C01C001
10C00C11C0C00101
1111111111111111