1111111111111111
10P00C0000C00001
1C1100010C00C001
11101C0010C00101
1E100C0000C01001
1111111111111111