1111111111111111
10000C0000C00001
10000C0000C00001
1C010P000C00C001
1111111111111111