1111111111111111
10P00C0000C001C1
1C1100010C00C111
11101C0010C0011
1E000C0000C01001
1111111111111111
