1111111111
1E0Ca00P01
1111111111